12 15
XXXXXXXXXXXXXXX
X|-----------|X
X|-|||||||||-|X
X|-|---|---|-|X
X|-|-|||||-|-|X
X|-|-|-|-|-|-|X
X|-|.|.|.|.|-|X
X|-+-+-+-+-+-|X
X|-|-|||||-|-|X
X|.|---|---|.|X
X|||||||||||||X
XXXXXXXXXXXXXXX
6
H 7 1 S -
H 7 8 S |
B 7 5 N |
B 7 6 S |
C 13 1 S |
T 1 1 S |
